5x5
s . . . .
. . . . .
. . . . .
. . d . .
. . . . .
